13 15
4 3
9 7
XXXXXXXXXXXXXXX
X846X853574267X
XXX9XXX1XXX6X3X
X3684986X433X8X
XXXSX6X9X3X3XXX
X891X9X6X14436X
XXX1XXXXXXX5X6X
X27767X23955X2X
X8XXX6X7XXX2XXX
X922X2XGX22326X
X7X2XXX3XXX2XXX
X932X28437X862X
XXXXXXXXXXXXXXX
